.........vv..........................................................................................................................................................................................$.
..........................................0................0......................0..................############....................................................................................$.
.....................0.....0......###########............###..................##..##..#.................0......0...........0.......................0.............##......##..........................$.
.........#..0...#..##..##..##..#.0..vvvvvvvvv..........##vvv.........0......#.......#^..........#..##############....#..#..#.#...........#.........#........0....vv......vv..........................$.
..@.0..#........#^^^^^^^^^^^^^^#.......................0.........#..........#....0..^...........#.0...^^^^^^^^^^^....#^^^^^^^^...........#^#^#^#^#^#........^........^.........0^....................$.
####################################^^^^^^^^^##############^^#####^^####^^#####^^##################################################^^##################################################^^##############