.......................................................................................................................................................................................................
.......................................................................................................................................................................................................
................................................#####...........................###...............................................#######..................##..........................................
.......................##.......................vvvvv........................#########....................#...#...............#...vvvvvvv........##...##...............................................
.@..##............. ###..............^.............................^......###############..............#^^^^^^^^^#..........#.....^^^^^^^..............................................................
#############################################################################################^^######################################################################...###############################
