..............................###.....................vv.............................................................................................................................................$.
..............................vvv...................................................................................................................................####.............................$.
...........................................0...............0...................................#..##..##..##........................................#...............vvvv.............................$.
.........0.............0.##.#..............#^^#............#.............#..#..#........#.....#...vv......vv.##............##..............##....0..#.............................#..................$.
.@...#...#............#.#..^............##^####^#........#^#^#....##...0.#^^####...#....#^^####...^^.....................######......0.....####^^####.............^.....0.........#.....0....^.......$.
######################^^^################################################################################^^####################^^###########################^^################^^#######################

