..............................###........................vvvvv.........................................................................................................................................
..............................vvv......................................................................................................................................................................
...............................................................................................#..##..##..##........................................#..................................................
.........................##.#..............#^^#............#.............#..#..#........#.....#...vv......vv.##............##..............##.......#..................................................
.@...#...#............#.#..^............##^####^#........#^#^#....##.....#^^####...#....#^^####...^^.....................######............####^^####..................................................
######################^^^################################################################################^^####################^^###########################^^#########################################

