..............................###........................vvvvv.........................................................................................................................................
..............................vvv......................................................................................................................................................................
.......................................................................................................................................................................................................
.........................##.#..............#^^#............#...........................................................................................................................................
.@...#...#............#.#..^.............#^####^#........#^#^#.........................................................................................................................................
######################^^^##############################################################################################################################################################################

