.......................................................................................................................................................................................................
.......................................................................................................................................................................................................
...........................0....................#####...........................###...............................................#######..................##..........................................
.........0.............##............0..........vvvvv........................#########....................#...#...............#...vvvvvvv........##...##...............................................
.@..##.......0..... ###..............^.............................^......###############..............#^^^^^^^^^#..........#.....^^^^^^^..............................................................
#############################################################################################^^######################################################################...###############################
